OOOOOOOOOO
O F O    O
N F O    X
O   O    X
O  FOO   X
OOO O  OOO
O  FO F  O
O OOO  O O
O      O O
OOOOOOOOOO